SO ./textures/bluestone.png
NO ./textures/eagle.png

WE ./textures/pillar.png
EA ./textures/purplestone.png

C 0, 248, 253
F 17,71, 95

        11111111111111111 1111111
        1000000000110000010000001
        1011000001110000000000001
        1001000000000000000000001
111111111011000001110000000000001
100000000011000001110111111111111
11110111111111011100000010001
11110001111111011101010010001
11000100110101011100000010001
10001010000000001100000010001
10000100000000001101010000001
110N000111010101111101111000111
11110111 1110101 101111010001
11111111 1111111 111111111111