SO ./textures/eagle.png
NO ./textures/wall_2.png

WE ./textures/wall_4.png
EA ./textures/wall_3.png

C 0, 248, 253
F 17,71, 95

        1111111111111111111111111
        10000000001D0000000000001
        1011000001110000001D10001
        1001000000DD0000000N00001
11111111101100000111D1000001D10001
100000000011000001110111111111111
11110111111111011100000010001
11110111111111011101010010001
11000000110101011100000010001
10000000000000001100000010001
10000000000000001101010010001
1100000111010101111101111000111
11110111 1110101 101111010001
11111111 1111111 111111111111
