SO ./textures/eagle.png
NO ./textures/wall_2.png

WE ./textures/wall_4.png
EA ./textures/wall_3.png

C 0, 248, 253
F 17,71, 95
                                                                               
        1111111111111111111111111111D111111111111111111111111111111111111111111111111111111111111111111111111111111111111111111111111111111111111111111111111111111111111111111111111111111111111111111111111111
        10000000000D00000000000000000000000000000000000000000000000000000000000000000000000000000000000000000000000000000000000000000000000000000000000000000000000000000000000000000000000000000000000000000011
        1111111100011D111111111111111111111111111111111111111111111111111111111111111111111111111111111111111111111111111111111111111111111111111111111111111111111111111111111111111111111111111111111111111111
        10010000001D0W0000000000011111
        100100000001000000000000000101
11111111101100000111110000000000000D01
10000000001100000111011111111000000101
11110111111111011100000010001111111111
11110111111111011101010010001
11000000110101011100000010001
10000000000000001100000010001
10000000000000001101010000001
1100000111010101111101111000111
11110111 1110101 101111010001
11111111 1111111 111111111111
