SO ./textures/eagle.png
NO ./textures/bluestone.png

WE ./textures/wall_4.png
EA ./textures/wall_3.png

C 0, 248, 253
F 17,71, 95

        1111111111111111111111111
        100000000011000000000000111
        101100000000000000000000001
        10010000000000000N000000011
111111111011000001110000000000001
100000000011000001110111111111111
11110111111111011100000010001
11110001111111011101010010001
11000100110101011100000010001
10001010000000001100000010001
10000100000000001101010000001
1100000111010101111101111000111
11110111 1110101 101111010001
11111111 1111111 111111111111